; demo map: '.' empty, '#' ground, 'P' player spawn
................
................
.......P........
......####......
################
